11111111111111
10C0000P111111
10000CCC000111
1100E000C11001
11111111111111
