1111111111111111111111111
10001P111C111110000000001
10C000C0000E00000C0000001
10C0000000000CCC000011001
11000C00C0000C11110001101
1000111001100000110000101
1000000000010001011001CC1
1111111111111111111111111
