1111111111111111111
1P110000C0000011001
1000000CCC0110000C1
100CE000000C1100C11
1000000011C11100001
1001110000000001111
10000CCC00000000001
1CC01C001000CC01C01
1000000000000000001
1111111111111111111
