111111111
10000CC11
10E0CC001
111111111
