11111111
1P1000C1
1001CC01
11111111
