11111111111
1R989C00001
1uckP11CC01
11111111111
