111111111111111
1000CC110011C11
1P000CC0001E101
111111111111111
